"Braund, Mr. Owen Harris"	male	22
"Cumings, Mrs. John Bradley (Florence Briggs Thayer)"	female	38
"Heikkinen, Miss. Laina"	female	26
"Futrelle, Mrs. Jacques Heath (Lily May Peel)"	female	35
"Allen, Mr. William Henry"	male	35
"Moran, Mr. James"	male	25
"McCarthy, Mr. Timothy J"	male	54
"Palsson, Master. Gosta Leonard"	male	2
"Johnson, Mrs. Oscar W (Elisabeth Vilhelmina Berg)"	female	27
"Nasser, Mrs. Nicholas (Adele Achem)"	female	14
"Sandstrom, Miss. Marguerite Rut"	female	4
"Bonnell, Miss. Elizabeth"	female	58
"Saundercock, Mr. William Henry"	male	20
"Andersson, Mr. Anders Johan"	male	39
"Vestrom, Miss. Hulda Amanda Adolfina"	female	14
"Hewlett, Mrs. (Mary D Kingcome) "	female	55
"Rice, Master. Eugene"	male	2
"Williams, Mr. Charles Eugene"	male	45
"Vander Planke, Mrs. Julius (Emelia Maria Vandemoortele)"	female	31
"Masselmani, Mrs. Fatima"	female	35
"Fynney, Mr. Joseph J"	male	35
"Beesley, Mr. Lawrence"	male	34
"McGowan, Miss. Anna ""Annie"""	female	15
"Sloper, Mr. William Thompson"	male	28
"Palsson, Miss. Torborg Danira"	female	8
"Asplund, Mrs. Carl Oscar (Selma Augusta Emilia Johansson)"	female	38
"Emir, Mr. Farred Chehab"	male	21
"Fortune, Mr. Charles Alexander"	male	19
"O'Dwyer, Miss. Ellen ""Nellie"""	female	24
"Todoroff, Mr. Lalio"	male	32
"Uruchurtu, Don. Manuel E"	male	40
"Spencer, Mrs. William Augustus (Marie Eugenie)"	female	56
"Glynn, Miss. Mary Agatha"	female	43
"Wheadon, Mr. Edward H"	male	66
"Meyer, Mr. Edgar Joseph"	male	28
"Holverson, Mr. Alexander Oskar"	male	42
"Mamee, Mr. Hanna"	male	71
"Cann, Mr. Ernest Charles"	male	21
"Vander Planke, Miss. Augusta Maria"	female	18
"Nicola-Yarred, Miss. Jamila"	female	14
"Ahlin, Mrs. Johan (Johanna Persdotter Larsson)"	female	40
"Turpin, Mrs. William John Robert (Dorothy Ann Wonnacott)"	female	27
"Kraeff, Mr. Theodor"	male	12
"Laroche, Miss. Simonne Marie Anne Andree"	female	3
"Devaney, Miss. Margaret Delia"	female	19
"Rogers, Mr. William John"	male	19
"Lennon, Mr. Denis"	male	24
"O'Driscoll, Miss. Bridget"	female	25
"Samaan, Mr. Youssef"	male	27
"Arnold-Franchi, Mrs. Josef (Josefine Franchi)"	female	18
"Panula, Master. Juha Niilo"	male	7
"Nosworthy, Mr. Richard Cater"	male	21
"Harper, Mrs. Henry Sleeper (Myna Haxtun)"	female	49
"Faunthorpe, Mrs. Lizzie (Elizabeth Anne Wilkinson)"	female	29
"Ostby, Mr. Engelhart Cornelius"	male	65
"Woolner, Mr. Hugh"	male	76
"Rugg, Miss. Emily"	female	21
"Novel, Mr. Mansouer"	male	28.5
"West, Miss. Constance Mirium"	female	5
"Goodwin, Master. William Frederick"	male	11
"Sirayanian, Mr. Orsen"	male	22
"Icard, Miss. Amelie"	female	38
"Harris, Mr. Henry Birkhardt"	male	45
"Skoog, Master. Harald"	male	4
"Stewart, Mr. Albert A"	male	82
"Moubarek, Master. Gerios"	male	95
"Nye, Mrs. (Elizabeth Ramell)"	female	29
"Crease, Mr. Ernest James"	male	19
"Andersson, Miss. Erna Alexandra"	female	17
"Kink, Mr. Vincenz"	male	26
"Jenkin, Mr. Stephen Curnow"	male	32
"Goodwin, Miss. Lillian Amy"	female	16
"Hood, Mr. Ambrose Jr"	male	21
"Chronopoulos, Mr. Apostolos"	male	26
"Bing, Mr. Lee"	male	32
"Moen, Mr. Sigurd Hansen"	male	25
"Staneff, Mr. Ivan"	male	22
"Moutal, Mr. Rahamin Haim"	male	25
"Caldwell, Master. Alden Gates"	male	0.83
"Dowdell, Miss. Elizabeth"	female	30
"Waelens, Mr. Achille"	male	22
"Sheerlinck, Mr. Jan Baptist"	male	29
"McDermott, Miss. Brigdet Delia"	female	44
"Carrau, Mr. Francisco M"	male	28
"Ilett, Miss. Bertha"	female	17
"Backstrom, Mrs. Karl Alfred (Maria Mathilda Gustafsson)"	female	33
"Ford, Mr. William Neal"	male	16
"Slocovski, Mr. Selman Francis"	male	32
"Fortune, Miss. Mabel Helen"	female	23
"Celotti, Mr. Francesco"	male	24
"Christmann, Mr. Emil"	male	29
"Andreasson, Mr. Paul Edvin"	male	20
"Chaffee, Mr. Herbert Fuller"	male	46
"Dean, Mr. Bertram Frank"	male	26
"Coxon, Mr. Daniel"	male	59
"Shorney, Mr. Charles Joseph"	male	78
"Goldschmidt, Mr. George B"	male	71
"Greenfield, Mr. William Bertram"	male	23
"Doling, Mrs. John T (Ada Julia Bone)"	female	34
"Kantor, Mr. Sinai"	male	34
"Petranec, Miss. Matilda"	female	28
"Petroff, Mr. Pastcho (""Pentcho"")"	male	23
"White, Mr. Richard Frasar"	male	21
"Johansson, Mr. Gustaf Joel"	male	33
"Gustafsson, Mr. Anders Vilhelm"	male	37
"Mionoff, Mr. Stoytcho"	male	28
"Salkjelsvik, Miss. Anna Kristine"	female	21
"Moss, Mr. Albert Johan"	male	11
"Rekic, Mr. Tido"	male	38
"Moran, Miss. Bertha"	female	8
"Porter, Mr. Walter Chamberlain"	male	47
"Zabour, Miss. Hileni"	female	14.5
"Barton, Mr. David John"	male	22
"Jussila, Miss. Katriina"	female	20
"Attalah, Miss. Malake"	female	17
"Pekoniemi, Mr. Edvard"	male	21
"Connors, Mr. Patrick"	male	70.5
"Turpin, Mr. William John Robert"	male	29
"Baxter, Mr. Quigg Edmond"	male	24
"Andersson, Miss. Ellis Anna Maria"	female	2
"Hickman, Mr. Stanley George"	male	21
"Moore, Mr. Leonard Charles"	male	29
"Nasser, Mr. Nicholas"	male	32.5
"Webber, Miss. Susan"	female	32.5
"White, Mr. Percival Wayland"	male	54
"Nicola-Yarred, Master. Elias"	male	12
"McMahon, Mr. Martin"	male	65
"Madsen, Mr. Fridtjof Arne"	male	24
"Peter, Miss. Anna"	female	63
"Ekstrom, Mr. Johan"	male	45
"Drazenoic, Mr. Jozef"	male	33
"Coelho, Mr. Domingos Fernandeo"	male	20
"Robins, Mrs. Alexander A (Grace Charity Laury)"	female	47
"Weisz, Mrs. Leopold (Mathilde Francoise Pede)"	female	29
"Sobey, Mr. Samuel James Hayden"	male	25
"Richard, Mr. Emile"	male	23
"Newsom, Miss. Helen Monypeny"	female	19
"Futrelle, Mr. Jacques Heath"	male	37
"Osen, Mr. Olaf Elon"	male	16
"Giglio, Mr. Victor"	male	24
"Boulos, Mrs. Joseph (Sultana)"	female	45
"Nysten, Miss. Anna Sofia"	female	22
"Hakkarainen, Mrs. Pekka Pietari (Elin Matilda Dolck)"	female	24
"Burke, Mr. Jeremiah"	male	19
"Andrew, Mr. Edgardo Samuel"	male	18
"Nicholls, Mr. Joseph Charles"	male	19
"Andersson, Mr. August Edvard (""Wennerstrom"")"	male	27
"Ford, Miss. Robina Maggie ""Ruby"""	female	9
"Navratil, Mr. Michel (""Louis M Hoffman"")"	male	36.5
"Byles, Rev. Thomas Roussel Davids"	male	42
"Bateman, Rev. Robert James"	male	51
"Pears, Mrs. Thomas (Edith Wearne)"	female	22
"Meo, Mr. Alfonzo"	male	55.5
"van Billiard, Mr. Austin Blyler"	male	40.5
"Olsen, Mr. Ole Martin"	male	55
"Williams, Mr. Charles Duane"	male	51
"Gilnagh, Miss. Katherine ""Katie"""	female	16
"Corn, Mr. Harry"	male	30
"Smiljanic, Mr. Mile"	male	35
"Sage, Master. Thomas Henry"	male	45
"Cribb, Mr. John Hatfield"	male	44
"Watt, Mrs. James (Elizabeth ""Bessie"" Inglis Milne)"	female	40
"Bengtsson, Mr. John Viktor"	male	26
"Calic, Mr. Jovo"	male	17
"Panula, Master. Eino Viljami"	male	1
"Goldsmith, Master. Frank John William ""Frankie"""	male	9
"Chibnall, Mrs. (Edith Martha Bowerman)"	female	4
"Skoog, Mrs. William (Anna Bernhardina Karlsson)"	female	45
"Baumann, Mr. John D"	male	12
"Ling, Mr. Lee"	male	28
"Van der hoef, Mr. Wyckoff"	male	61
"Rice, Master. Arthur"	male	4
"Johnson, Miss. Eleanor Ileen"	female	1
"Sivola, Mr. Antti Wilhelm"	male	21
"Smith, Mr. James Clinch"	male	56
"Klasen, Mr. Klas Albin"	male	18
"Lefebre, Master. Henry Forbes"	male	56
"Isham, Miss. Ann Elizabeth"	female	50
"Hale, Mr. Reginald"	male	30
"Leonard, Mr. Lionel"	male	36
"Sage, Miss. Constance Gladys"	female	78
"Pernot, Mr. Rene"	male	85
"Asplund, Master. Clarence Gustaf Hugo"	male	9
"Becker, Master. Richard F"	male	1
"Kink-Heilmann, Miss. Luise Gretchen"	female	4
"Rood, Mr. Hugh Roscoe"	male	95
"O'Brien, Mrs. Thomas (Johanna ""Hannah"" Godfrey)"	female	82
"Romaine, Mr. Charles Hallace (""Mr C Rolmane"")"	male	45
"Bourke, Mr. John"	male	40
"Turcin, Mr. Stjepan"	male	36
"Pinsky, Mrs. (Rosa)"	female	32
"Carbines, Mr. William"	male	19
"Andersen-Jensen, Miss. Carla Christine Nielsine"	female	19
"Navratil, Master. Michel M"	male	3
"Brown, Mrs. James Joseph (Margaret Tobin)"	female	44
"Lurette, Miss. Elise"	female	58
"Mernagh, Mr. Robert"	male	69
"Olsen, Mr. Karl Siegwart Andreas"	male	42
"Madigan, Miss. Margaret ""Maggie"""	female	23
"Yrois, Miss. Henriette (""Mrs Harbeck"")"	female	24
"Vande Walle, Mr. Nestor Cyriel"	male	28
"Sage, Mr. Frederick"	male	25
"Johanson, Mr. Jakob Alfred"	male	34
"Youseff, Mr. Gerious"	male	45.5
"Cohen, Mr. Gurshon ""Gus"""	male	18
"Strom, Miss. Telma Matilda"	female	2
"Backstrom, Mr. Karl Alfred"	male	32
"Albimona, Mr. Nassef Cassem"	male	26
"Carr, Miss. Helen ""Ellen"""	female	16
"Blank, Mr. Henry"	male	40
"Ali, Mr. Ahmed"	male	24
"Cameron, Miss. Clear Annie"	female	35
"Perkin, Mr. John Henry"	male	22
"Givard, Mr. Hans Kristensen"	male	30
"Kiernan, Mr. Philip"	male	25
"Newell, Miss. Madeleine"	female	31
"Honkanen, Miss. Eliina"	female	27
"Jacobsohn, Mr. Sidney Samuel"	male	42
"Bazzani, Miss. Albina"	female	32
"Harris, Mr. Walter"	male	30
"Sunderland, Mr. Victor Francis"	male	16
"Bracken, Mr. James H"	male	27
"Green, Mr. George Henry"	male	51
"Nenkoff, Mr. Christo"	male	25
"Hoyt, Mr. Frederick Maxfield"	male	38
"Berglund, Mr. Karl Ivar Sven"	male	22
"Mellors, Mr. William John"	male	19
"Lovell, Mr. John Hall (""Henry"")"	male	20.5
"Fahlstrom, Mr. Arne Jonas"	male	18
"Lefebre, Miss. Mathilde"	female	25
"Harris, Mrs. Henry Birkhardt (Irene Wallach)"	female	35
"Larsson, Mr. Bengt Edvin"	male	29
"Sjostedt, Mr. Ernst Adolf"	male	59
"Asplund, Miss. Lillian Gertrud"	female	5
"Leyson, Mr. Robert William Norman"	male	24
"Harknett, Miss. Alice Phoebe"	female	25
"Hold, Mr. Stephen"	male	44
"Collyer, Miss. Marjorie ""Lottie"""	female	8
"Pengelly, Mr. Frederick William"	male	19
"Hunt, Mr. George Henry"	male	33
"Zabour, Miss. Thamine"	female	25
"Murphy, Miss. Katherine ""Kate"""	female	25
"Coleridge, Mr. Reginald Charles"	male	29
"Maenpaa, Mr. Matti Alexanteri"	male	22
"Attalah, Mr. Sleiman"	male	30
"Minahan, Dr. William Edward"	male	44
"Lindahl, Miss. Agda Thorilda Viktoria"	female	25
"Hamalainen, Mrs. William (Anna)"	female	24
"Beckwith, Mr. Richard Leonard"	male	37
"Carter, Rev. Ernest Courtenay"	male	54
"Reed, Mr. James George"	male	25
"Strom, Mrs. Wilhelm (Elna Matilda Persson)"	female	29
"Stead, Mr. William Thomas"	male	62
"Lobb, Mr. William Arthur"	male	30
"Rosblom, Mrs. Viktor (Helena Wilhelmina)"	female	41
"Touma, Mrs. Darwis (Hanne Youssef Razi)"	female	29
"Thorne, Mrs. Gertrude Maybelle"	female	25
"Cherry, Miss. Gladys"	female	30
"Ward, Miss. Anna"	female	35
"Parrish, Mrs. (Lutie Davis)"	female	50
"Smith, Mr. Thomas"	male	35
"Asplund, Master. Edvin Rojj Felix"	male	3
"Taussig, Mr. Emil"	male	52
"Harrison, Mr. William"	male	40
"Henry, Miss. Delia"	female	35
"Reeves, Mr. David"	male	36
"Panula, Mr. Ernesti Arvid"	male	16
"Persson, Mr. Ernst Ulrik"	male	25
"Graham, Mrs. William Thompson (Edith Junkins)"	female	58
"Bissette, Miss. Amelia"	female	35
"Cairns, Mr. Alexander"	male	35
"Tornquist, Mr. William Henry"	male	25
"Mellinger, Mrs. (Elizabeth Anne Maidment)"	female	41
"Natsch, Mr. Charles H"	male	37
"Healy, Miss. Hanora ""Nora"""	female	35
"Andrews, Miss. Kornelia Theodosia"	female	63
"Lindblom, Miss. Augusta Charlotta"	female	45
"Parkes, Mr. Francis ""Frank"""	male	35
"Rice, Master. Eric"	male	7
"Abbott, Mrs. Stanton (Rosa Hunt)"	female	35
"Duane, Mr. Frank"	male	65
"Olsson, Mr. Nils Johan Goransson"	male	28
"de Pelsmaeker, Mr. Alfons"	male	16
"Dorking, Mr. Edward Arthur"	male	19
"Smith, Mr. Richard William"	male	35
"Stankovic, Mr. Ivan"	male	33
"de Mulder, Mr. Theodore"	male	30
"Naidenoff, Mr. Penko"	male	22
"Hosono, Mr. Masabumi"	male	42
"Connolly, Miss. Kate"	female	22
"Barber, Miss. Ellen ""Nellie"""	female	26
"Bishop, Mrs. Dickinson H (Helen Walton)"	female	19
"Levy, Mr. Rene Jacques"	male	36
"Haas, Miss. Aloisia"	female	24
"Mineff, Mr. Ivan"	male	24
"Lewy, Mr. Ervin G"	male	35
"Hanna, Mr. Mansour"	male	23.5
"Allison, Miss. Helen Loraine"	female	2
"Saalfeld, Mr. Adolphe"	male	45
"Baxter, Mrs. James (Helene DeLaudeniere Chaput)"	female	50
"Kelly, Miss. Anna Katherine ""Annie Kate"""	female	45
"McCoy, Mr. Bernard"	male	45
"Johnson, Mr. William Cahoone Jr"	male	19
"Keane, Miss. Nora A"	female	45
"Williams, Mr. Howard Hugh ""Harry"""	male	45
"Allison, Master. Hudson Trevor"	male	0.92
"Fleming, Miss. Margaret"	female	45
"Penasco y Castellana, Mrs. Victor de Satode (Maria Josefa Perez de Soto y Vallejo)"	female	17
"Abelson, Mr. Samuel"	male	30
"Francatelli, Miss. Laura Mabel"	female	30
"Hays, Miss. Margaret Bechstein"	female	24
"Ryerson, Miss. Emily Borie"	female	18
"Lahtinen, Mrs. William (Anna Sylfven)"	female	26
"Hendekovic, Mr. Ignjac"	male	28
"Hart, Mr. Benjamin"	male	43
"Nilsson, Miss. Helmina Josefina"	female	26
"Kantor, Mrs. Sinai (Miriam Sternin)"	female	24
"Moraweck, Dr. Ernest"	male	54
"Wick, Miss. Mary Natalie"	female	31
"Spedden, Mrs. Frederic Oakley (Margaretta Corning Stone)"	female	40
"Dennis, Mr. Samuel"	male	22
"Danoff, Mr. Yoto"	male	27
"Slayter, Miss. Hilda Mary"	female	30
"Caldwell, Mrs. Albert Francis (Sylvia Mae Harbaugh)"	female	22
"Sage, Mr. George John Jr"	male	45
"Young, Miss. Marie Grice"	female	36
"Nysveen, Mr. Johan Hansen"	male	61
"Ball, Mrs. (Ada E Hall)"	female	36
"Goldsmith, Mrs. Frank John (Emily Alice Brown)"	female	31
"Hippach, Miss. Jean Gertrude"	female	16
"McCoy, Miss. Agnes"	female	45
"Partner, Mr. Austen"	male	45.5
"Graham, Mr. George Edward"	male	38
"Vander Planke, Mr. Leo Edmondus"	male	16
"Frauenthal, Mrs. Henry William (Clara Heinsheimer)"	female	45
"Denkoff, Mr. Mitto"	male	45
"Pears, Mr. Thomas Clinton"	male	29
"Burns, Miss. Elizabeth Margaret"	female	41
"Dahl, Mr. Karl Edwart"	male	45
"Blackwell, Mr. Stephen Weart"	male	45
"Navratil, Master. Edmond Roger"	male	2
"Fortune, Miss. Alice Elizabeth"	female	24
"Collander, Mr. Erik Gustaf"	male	28
"Sedgwick, Mr. Charles Frederick Waddington"	male	25
"Fox, Mr. Stanley Hubert"	male	36
"Brown, Miss. Amelia ""Mildred"""	female	24
"Smith, Miss. Marion Elsie"	female	40
"Davison, Mrs. Thomas Henry (Mary E Finck)"	female	45
"Coutts, Master. William Loch ""William"""	male	3
"Dimic, Mr. Jovan"	male	42
"Odahl, Mr. Nils Martin"	male	23
"Williams-Lambert, Mr. Fletcher Fellows"	male	55
"Elias, Mr. Tannous"	male	15
"Arnold-Franchi, Mr. Josef"	male	25
"Yousif, Mr. Wazli"	male	55
"Vanden Steen, Mr. Leo Peter"	male	28
"Bowerman, Miss. Elsie Edith"	female	22
"Funk, Miss. Annie Clemmer"	female	38
"McGovern, Miss. Mary"	female	55
"Mockler, Miss. Helen Mary ""Ellie"""	female	55
"Skoog, Mr. Wilhelm"	male	40
"del Carlo, Mr. Sebastiano"	male	29
"Barbara, Mrs. (Catherine David)"	female	45
"Asim, Mr. Adola"	male	35
"O'Brien, Mr. Thomas"	male	55
"Adahl, Mr. Mauritz Nils Martin"	male	30
"Warren, Mrs. Frank Manley (Anna Sophia Atkinson)"	female	60
"Moussa, Mrs. (Mantoura Boulos)"	female	55
"Jermyn, Miss. Annie"	female	55
"Aubart, Mme. Leontine Pauline"	female	24
"Harder, Mr. George Achilles"	male	25
"Wiklund, Mr. Jakob Alfred"	male	18
"Beavan, Mr. William Thomas"	male	19
"Ringhini, Mr. Sante"	male	22
"Palsson, Miss. Stina Viola"	female	3
"Meyer, Mrs. Edgar Joseph (Leila Saks)"	female	55
"Landergren, Miss. Aurora Adelia"	female	22
"Widener, Mr. Harry Elkins"	male	27
"Betros, Mr. Tannous"	male	20
"Gustafsson, Mr. Karl Gideon"	male	19
"Bidois, Miss. Rosalie"	female	42
"Nakid, Miss. Maria (""Mary"")"	female	1
"Tikkanen, Mr. Juho"	male	32
"Holverson, Mrs. Alexander Oskar (Mary Aline Towner)"	female	35
"Plotcharsky, Mr. Vasil"	male	55
"Davies, Mr. Charles Henry"	male	18
"Goodwin, Master. Sidney Leonard"	male	1
"Buss, Miss. Kate"	female	36
"Sadlier, Mr. Matthew"	male	55
"Lehmann, Miss. Bertha"	female	17
"Carter, Mr. William Ernest"	male	36
"Jansson, Mr. Carl Olof"	male	21
"Gustafsson, Mr. Johan Birger"	male	28
"Newell, Miss. Marjorie"	female	23
"Sandstrom, Mrs. Hjalmar (Agnes Charlotta Bengtsson)"	female	24
"Johansson, Mr. Erik"	male	22
"Olsson, Miss. Elina"	female	31
"McKane, Mr. Peter David"	male	46
"Pain, Dr. Alfred"	male	23
"Trout, Mrs. William H (Jessie L)"	female	28
"Niskanen, Mr. Juha"	male	39
"Adams, Mr. John"	male	26
"Jussila, Miss. Mari Aina"	female	21
"Hakkarainen, Mr. Pekka Pietari"	male	28
"Oreskovic, Miss. Marija"	female	20
"Gale, Mr. Shadrach"	male	34
"Widegren, Mr. Carl/Charles Peter"	male	51
"Richards, Master. William Rowe"	male	3
"Birkeland, Mr. Hans Martin Monsen"	male	21
"Lefebre, Miss. Ida"	female	55
"Sdycoff, Mr. Todor"	male	55
"Hart, Mr. Henry"	male	55
"Minahan, Miss. Daisy E"	female	33
"Cunningham, Mr. Alfred Fleming"	male	55
"Sundman, Mr. Johan Julian"	male	44
"Meek, Mrs. Thomas (Annie Louise Rowley)"	female	55
"Drew, Mrs. James Vivian (Lulu Thorne Christian)"	female	34
"Silven, Miss. Lyyli Karoliina"	female	18
"Matthews, Mr. William John"	male	30
"Van Impe, Miss. Catharina"	female	10
"Gheorgheff, Mr. Stanio"	male	65
"Charters, Mr. David"	male	21
"Zimmerman, Mr. Leo"	male	29
"Danbom, Mrs. Ernst Gilbert (Anna Sigrid Maria Brogren)"	female	28
"Rosblom, Mr. Viktor Richard"	male	18
"Wiseman, Mr. Phillippe"	male	65
"Clarke, Mrs. Charles V (Ada Maria Winfield)"	female	28
"Phillips, Miss. Kate Florence (""Mrs Kate Louise Phillips Marshall"")"	female	19
"Flynn, Mr. James"	male	65
"Pickard, Mr. Berk (Berk Trembisky)"	male	32
"Bjornstrom-Steffansson, Mr. Mauritz Hakan"	male	28
"Thorneycroft, Mrs. Percival (Florence Kate White)"	female	65
"Louch, Mrs. Charles Alexander (Alice Adelaide Slow)"	female	42
"Kallio, Mr. Nikolai Erland"	male	17
"Silvey, Mr. William Baird"	male	50
"Carter, Miss. Lucile Polk"	female	14
"Ford, Miss. Doolina Margaret ""Daisy"""	female	21
"Richards, Mrs. Sidney (Emily Hocking)"	female	24
"Fortune, Mr. Mark"	male	64
"Kvillner, Mr. Johan Henrik Johannesson"	male	31
"Hart, Mrs. Benjamin (Esther Ada Bloomfield)"	female	45
"Hampe, Mr. Leon"	male	20
"Petterson, Mr. Johan Emil"	male	25
"Reynaldo, Ms. Encarnacion"	female	28
"Johannesen-Bratthammer, Mr. Bernt"	male	65
"Dodge, Master. Washington"	male	4
"Mellinger, Miss. Madeleine Violet"	female	13
"Seward, Mr. Frederic Kimber"	male	34
"Baclini, Miss. Marie Catherine"	female	5
"Peuchen, Major. Arthur Godfrey"	male	52
"West, Mr. Edwy Arthur"	male	36
"Hagland, Mr. Ingvald Olai Olsen"	male	65
"Foreman, Mr. Benjamin Laventall"	male	30
"Goldenberg, Mr. Samuel L"	male	49
"Peduzzi, Mr. Joseph"	male	65
"Jalsevac, Mr. Ivan"	male	29
"Millet, Mr. Francis Davis"	male	65
"Kenyon, Mrs. Frederick R (Marion)"	female	65
"Toomey, Miss. Ellen"	female	50
"O'Connor, Mr. Maurice"	male	65
"Anderson, Mr. Harry"	male	48
"Morley, Mr. William"	male	34
"Gee, Mr. Arthur H"	male	47
"Milling, Mr. Jacob Christian"	male	48
"Maisner, Mr. Simon"	male	65
"Goncalves, Mr. Manuel Estanslas"	male	38
"Campbell, Mr. William"	male	65
"Smart, Mr. John Montgomery"	male	56
"Scanlan, Mr. James"	male	65
"Baclini, Miss. Helene Barbara"	female	0.75
"Keefe, Mr. Arthur"	male	65
"Cacic, Mr. Luka"	male	38
"West, Mrs. Edwy Arthur (Ada Mary Worth)"	female	33
"Jerwan, Mrs. Amin S (Marie Marthe Thuillard)"	female	23
"Strandberg, Miss. Ida Sofia"	female	22
"Clifford, Mr. George Quincy"	male	65
"Renouf, Mr. Peter Henry"	male	34
"Braund, Mr. Lewis Richard"	male	29
"Karlsson, Mr. Nils August"	male	22
"Hirvonen, Miss. Hildur E"	female	2
"Goodwin, Master. Harold Victor"	male	9
"Frost, Mr. Anthony Wood ""Archie"""	male	65
"Rouse, Mr. Richard Henry"	male	50
"Turkula, Mrs. (Hedwig)"	female	63
"Bishop, Mr. Dickinson H"	male	25
"Lefebre, Miss. Jeannie"	female	65
"Hoyt, Mrs. Frederick Maxfield (Jane Anne Forby)"	female	35
"Kent, Mr. Edward Austin"	male	58
"Somerton, Mr. Francis William"	male	30
"Coutts, Master. Eden Leslie ""Neville"""	male	9
"Hagland, Mr. Konrad Mathias Reiersen"	male	65
"Windelov, Mr. Einar"	male	21
"Molson, Mr. Harry Markland"	male	55
"Artagaveytia, Mr. Ramon"	male	71
"Stanley, Mr. Edward Roland"	male	21
"Yousseff, Mr. Gerious"	male	65
"Eustis, Miss. Elizabeth Mussey"	female	54
"Shellard, Mr. Frederick William"	male	65
"Allison, Mrs. Hudson J C (Bessie Waldo Daniels)"	female	25
"Svensson, Mr. Olof"	male	24
"Calic, Mr. Petar"	male	17
"Canavan, Miss. Mary"	female	21
"O'Sullivan, Miss. Bridget Mary"	female	65
"Laitinen, Miss. Kristina Sofia"	female	37
"Maioni, Miss. Roberta"	female	16
"Penasco y Castellana, Mr. Victor de Satode"	male	18
"Quick, Mrs. Frederick Charles (Jane Richards)"	female	33
"Bradley, Mr. George (""George Arthur Brayton"")"	male	65
"Olsen, Mr. Henry Margido"	male	28
"Lang, Mr. Fang"	male	26
"Daly, Mr. Eugene Patrick"	male	29
"Webber, Mr. James"	male	75
"McGough, Mr. James Robert"	male	36
"Rothschild, Mrs. Martin (Elizabeth L. Barrett)"	female	54
"Coleff, Mr. Satio"	male	24
"Walker, Mr. William Anderson"	male	47
"Lemore, Mrs. (Amelia Milley)"	female	34
"Ryan, Mr. Patrick"	male	75
"Angle, Mrs. William A (Florence ""Mary"" Agnes Hughes)"	female	36
"Pavlovic, Mr. Stefo"	male	32
"Perreault, Miss. Anne"	female	30
"Vovk, Mr. Janko"	male	22
"Lahoud, Mr. Sarkis"	male	75
"Hippach, Mrs. Louis Albert (Ida Sophia Fischer)"	female	44
"Kassem, Mr. Fared"	male	75
"Farrell, Mr. James"	male	40.5
"Ridsdale, Miss. Lucy"	female	50
"Farthing, Mr. John"	male	75
"Salonen, Mr. Johan Werner"	male	39
"Hocking, Mr. Richard George"	male	23
"Quick, Miss. Phyllis May"	female	2
"Toufik, Mr. Nakli"	male	75
"Elias, Mr. Joseph Jr"	male	17
"Peter, Mrs. Catherine (Catherine Rizk)"	female	75
"Cacic, Miss. Marija"	female	30
"Hart, Miss. Eva Miriam"	female	7
"Butt, Major. Archibald Willingham"	male	45
"LeRoy, Miss. Bertha"	female	30
"Risien, Mr. Samuel Beard"	male	75
"Frolicher, Miss. Hedwig Margaritha"	female	22
"Crosby, Miss. Harriet R"	female	36
"Andersson, Miss. Ingeborg Constanzia"	female	9
"Andersson, Miss. Sigrid Elisabeth"	female	11
"Beane, Mr. Edward"	male	32
"Douglas, Mr. Walter Donald"	male	50
"Nicholson, Mr. Arthur Ernest"	male	64
"Beane, Mrs. Edward (Ethel Clarke)"	female	19
"Padro y Manent, Mr. Julian"	male	75
"Goldsmith, Mr. Frank John"	male	33
"Davies, Master. John Morgan Jr"	male	8
"Thayer, Mr. John Borland Jr"	male	17
"Sharp, Mr. Percival James R"	male	27
"O'Brien, Mr. Timothy"	male	75
"Leeni, Mr. Fahim (""Philip Zenni"")"	male	22
"Ohman, Miss. Velin"	female	22
"Wright, Mr. George"	male	62
"Duff Gordon, Lady. (Lucille Christiana Sutherland) (""Mrs Morgan"")"	female	48
"Robbins, Mr. Victor"	male	75
"Taussig, Mrs. Emil (Tillie Mandelbaum)"	female	39
"de Messemaeker, Mrs. Guillaume Joseph (Emma)"	female	36
"Morrow, Mr. Thomas Rowan"	male	75
"Sivic, Mr. Husein"	male	40
"Norman, Mr. Robert Douglas"	male	28
"Simmons, Mr. John"	male	75
"Meanwell, Miss. (Marion Ogden)"	female	85
"Davies, Mr. Alfred J"	male	24
"Stoytcheff, Mr. Ilia"	male	19
"Palsson, Mrs. Nils (Alma Cornelia Berglund)"	female	29
"Doharr, Mr. Tannous"	male	85
"Jonsson, Mr. Carl"	male	32
"Harris, Mr. George"	male	62
"Appleton, Mrs. Edward Dale (Charlotte Lamson)"	female	53
"Flynn, Mr. John Irwin (""Irving"")"	male	36
"Kelly, Miss. Mary"	female	85
"Rush, Mr. Alfred George John"	male	16
"Patchett, Mr. George"	male	19
"Garside, Miss. Ethel"	female	34
"Silvey, Mrs. William Baird (Alice Munger)"	female	39
"Caram, Mrs. Joseph (Maria Elias)"	female	85
"Jussila, Mr. Eiriik"	male	32
"Christy, Miss. Julie Rachel"	female	25
"Thayer, Mrs. John Borland (Marian Longstreth Morris)"	female	39
"Downton, Mr. William James"	male	54
"Ross, Mr. John Hugo"	male	36
"Paulner, Mr. Uscher"	male	85
"Taussig, Miss. Ruth"	female	18
"Jarvis, Mr. John Denzil"	male	47
"Frolicher-Stehli, Mr. Maxmillian"	male	60
"Gilinski, Mr. Eliezer"	male	22
"Murdlin, Mr. Joseph"	male	85
"Rintamaki, Mr. Matti"	male	35
"Stephenson, Mrs. Walter Bertram (Martha Eustis)"	female	52
"Elsbury, Mr. William James"	male	47
"Bourke, Miss. Mary"	female	85
"Chapman, Mr. John Henry"	male	37
"Van Impe, Mr. Jean Baptiste"	male	36
"Leitch, Miss. Jessie Wills"	female	85
"Johnson, Mr. Alfred"	male	49
"Boulos, Mr. Hanna"	male	85
"Duff Gordon, Sir. Cosmo Edmund (""Mr Morgan"")"	male	49
"Jacobsohn, Mrs. Sidney Samuel (Amy Frances Christy)"	female	24
"Slabenoff, Mr. Petco"	male	85
"Harrington, Mr. Charles H"	male	85
"Torber, Mr. Ernst William"	male	44
"Homer, Mr. Harry (""Mr E Haven"")"	male	35
"Lindell, Mr. Edvard Bengtsson"	male	36
"Karaic, Mr. Milan"	male	30
"Daniel, Mr. Robert Williams"	male	27
"Laroche, Mrs. Joseph (Juliette Marie Louise Lafargue)"	female	22
"Shutes, Miss. Elizabeth W"	female	40
"Andersson, Mrs. Anders Johan (Alfrida Konstantia Brogren)"	female	39
"Jardin, Mr. Jose Neto"	male	85
"Murphy, Miss. Margaret Jane"	female	85
"Horgan, Mr. John"	male	85
"Brocklebank, Mr. William Alfred"	male	35
"Herman, Miss. Alice"	female	24
"Danbom, Mr. Ernst Gilbert"	male	34
"Lobb, Mrs. William Arthur (Cordelia K Stanlick)"	female	26
"Becker, Miss. Marion Louise"	female	4
"Gavey, Mr. Lawrence"	male	26
"Yasbeck, Mr. Antoni"	male	27
"Kimball, Mr. Edwin Nelson Jr"	male	42
"Nakid, Mr. Sahid"	male	20
"Hansen, Mr. Henry Damsgaard"	male	21
"Bowen, Mr. David John ""Dai"""	male	21
"Sutton, Mr. Frederick"	male	61
"Kirkland, Rev. Charles Leonard"	male	57
"Longley, Miss. Gretchen Fiske"	female	21
"Bostandyeff, Mr. Guentcho"	male	26
"O'Connell, Mr. Patrick D"	male	85
"Barkworth, Mr. Algernon Henry Wilson"	male	80
"Lundahl, Mr. Johan Svensson"	male	51
"Stahelin-Maeglin, Dr. Max"	male	32
"Parr, Mr. William Henry Marsh"	male	85
"Skoog, Miss. Mabel"	female	9
"Davis, Miss. Mary"	female	28
"Leinonen, Mr. Antti Gustaf"	male	32
"Collyer, Mr. Harvey"	male	31
"Panula, Mrs. Juha (Maria Emilia Ojala)"	female	41
"Thorneycroft, Mr. Percival"	male	85
"Jensen, Mr. Hans Peder"	male	20
"Sagesser, Mlle. Emma"	female	24
"Skoog, Miss. Margit Elizabeth"	female	2
"Foo, Mr. Choong"	male	85
"Baclini, Miss. Eugenie"	female	0.75
"Harper, Mr. Henry Sleeper"	male	48
"Cor, Mr. Liudevit"	male	19
"Simonius-Blumer, Col. Oberst Alfons"	male	56
"Willey, Mr. Edward"	male	85
"Stanley, Miss. Amy Zillah Elsie"	female	23
"Mitkoff, Mr. Mito"	male	85
"Doling, Miss. Elsie"	female	18
"Kalvik, Mr. Johannes Halvorsen"	male	21
"O'Leary, Miss. Hanora ""Norah"""	female	85
"Hegarty, Miss. Hanora ""Nora"""	female	18
"Hickman, Mr. Leonard Mark"	male	24
"Radeff, Mr. Alexander"	male	85
"Bourke, Mrs. John (Catherine)"	female	32
"Eitemiller, Mr. George Floyd"	male	23
"Newell, Mr. Arthur Webster"	male	58
"Frauenthal, Dr. Henry William"	male	50
"Badt, Mr. Mohamed"	male	40
"Colley, Mr. Edward Pomeroy"	male	47
"Coleff, Mr. Peju"	male	36
"Lindqvist, Mr. Eino William"	male	20
"Hickman, Mr. Lewis"	male	32
"Butler, Mr. Reginald Fenton"	male	25
"Rommetvedt, Mr. Knud Paust"	male	85
"Cook, Mr. Jacob"	male	43
"Taylor, Mrs. Elmer Zebley (Juliet Cummins Wright)"	female	85
"Brown, Mrs. Thomas William Solomon (Elizabeth Catherine Ford)"	female	40
"Davidson, Mr. Thornton"	male	31
"Mitchell, Mr. Henry Michael"	male	70
"Wilhelms, Mr. Charles"	male	31
"Watson, Mr. Ennis Hastings"	male	85
"Edvardsson, Mr. Gustaf Hjalmar"	male	18
"Sawyer, Mr. Frederick Charles"	male	24.5
"Turja, Miss. Anna Sofia"	female	18
"Goodwin, Mrs. Frederick (Augusta Tyler)"	female	43
"Cardeza, Mr. Thomas Drake Martinez"	male	36
"Peters, Miss. Katie"	female	85
"Hassab, Mr. Hammad"	male	27
"Olsvigen, Mr. Thor Anderson"	male	20
"Goodwin, Mr. Charles Edward"	male	14
"Brown, Mr. Thomas William Solomon"	male	60
"Laroche, Mr. Joseph Philippe Lemercier"	male	25
"Panula, Mr. Jaako Arnold"	male	14
"Dakic, Mr. Branko"	male	19
"Fischer, Mr. Eberhard Thelander"	male	18
"Madill, Miss. Georgette Alexandra"	female	15
"Dick, Mr. Albert Adrian"	male	31
"Karun, Miss. Manca"	female	4
"Lam, Mr. Ali"	male	85
"Saad, Mr. Khalil"	male	25
"Weir, Col. John"	male	60
"Chapman, Mr. Charles Henry"	male	52
"Kelly, Mr. James"	male	44
"Mullens, Miss. Katherine ""Katie"""	female	85
"Thayer, Mr. John Borland"	male	49
"Humblen, Mr. Adolf Mathias Nicolai Olsen"	male	42
"Astor, Mrs. John Jacob (Madeleine Talmadge Force)"	female	18
"Silverthorne, Mr. Spencer Victor"	male	35
"Barbara, Miss. Saiide"	female	18
"Gallagher, Mr. Martin"	male	25
"Hansen, Mr. Henrik Juul"	male	26
"Morley, Mr. Henry Samuel (""Mr Henry Marshall"")"	male	39
"Kelly, Mrs. Florence ""Fannie"""	female	45
"Calderhead, Mr. Edward Pennington"	male	42
"Cleaver, Miss. Alice"	female	22
"Moubarek, Master. Halim Gonios (""William George"")"	male	85
"Mayne, Mlle. Berthe Antonine (""Mrs de Villiers"")"	female	24
"Klaber, Mr. Herman"	male	85
"Taylor, Mr. Elmer Zebley"	male	48
"Larsson, Mr. August Viktor"	male	29
"Greenberg, Mr. Samuel"	male	52
"Soholt, Mr. Peter Andreas Lauritz Andersen"	male	19
"Endres, Miss. Caroline Louise"	female	38
"Troutt, Miss. Edwina Celia ""Winnie"""	female	27
"McEvoy, Mr. Michael"	male	85
"Johnson, Mr. Malkolm Joackim"	male	33
"Harper, Miss. Annie Jessie ""Nina"""	female	6
"Jensen, Mr. Svend Lauritz"	male	17
"Gillespie, Mr. William Henry"	male	34
"Hodges, Mr. Henry Price"	male	50
"Chambers, Mr. Norman Campbell"	male	27
"Oreskovic, Mr. Luka"	male	20
"Renouf, Mrs. Peter Henry (Lillian Jefferys)"	female	30
"Mannion, Miss. Margareth"	female	85
"Bryhl, Mr. Kurt Arnold Gottfrid"	male	25
"Ilmakangas, Miss. Pieta Sofia"	female	25
"Allen, Miss. Elisabeth Walton"	female	29
"Hassan, Mr. Houssein G N"	male	11
"Knight, Mr. Robert J"	male	85
"Berriman, Mr. William John"	male	23
"Troupiansky, Mr. Moses Aaron"	male	23
"Williams, Mr. Leslie"	male	28.5
"Ford, Mrs. Edward (Margaret Ann Watson)"	female	48
"Lesurer, Mr. Gustave J"	male	35
"Ivanoff, Mr. Kanio"	male	85
"Nankoff, Mr. Minko"	male	85
"Hawksford, Mr. Walter James"	male	85
"Cavendish, Mr. Tyrell William"	male	36
"Ryerson, Miss. Susan Parker ""Suzette"""	female	21
"McNamee, Mr. Neal"	male	24
"Stranden, Mr. Juho"	male	31
"Crosby, Capt. Edward Gifford"	male	70
"Abbott, Mr. Rossmore Edward"	male	16
"Sinkkonen, Miss. Anna"	female	30
"Marvin, Mr. Daniel Warner"	male	19
"Connaghton, Mr. Michael"	male	31
"Wells, Miss. Joan"	female	4
"Moor, Master. Meier"	male	6
"Vande Velde, Mr. Johannes Joseph"	male	33
"Jonkoff, Mr. Lalio"	male	23
"Herman, Mrs. Samuel (Jane Laver)"	female	48
"Hamalainen, Master. Viljo"	male	0.67
"Carlsson, Mr. August Sigfrid"	male	28
"Bailey, Mr. Percy Andrew"	male	18
"Theobald, Mr. Thomas Leonard"	male	34
"Rothes, the Countess. of (Lucy Noel Martha Dyer-Edwards)"	female	33
"Garfirth, Mr. John"	male	85
"Nirva, Mr. Iisakki Antino Aijo"	male	41
"Barah, Mr. Hanna Assi"	male	20
"Carter, Mrs. William Ernest (Lucile Polk)"	female	36
"Eklund, Mr. Hans Linus"	male	16
"Hogeboom, Mrs. John C (Anna Andrews)"	female	51
"Brewe, Dr. Arthur Jackson"	male	85
"Mangan, Miss. Mary"	female	30.5
"Moran, Mr. Daniel J"	male	85
"Gronnestad, Mr. Daniel Danielsen"	male	32
"Lievens, Mr. Rene Aime"	male	24
"Jensen, Mr. Niels Peder"	male	48
"Mack, Mrs. (Mary)"	female	57
"Elias, Mr. Dibo"	male	85
"Hocking, Mrs. Elizabeth (Eliza Needs)"	female	54
"Myhrman, Mr. Pehr Fabian Oliver Malkolm"	male	18
"Tobin, Mr. Roger"	male	85
"Emanuel, Miss. Virginia Ethel"	female	5
"Kilgannon, Mr. Thomas J"	male	85
"Robert, Mrs. Edward Scott (Elisabeth Walton McMillan)"	female	43
"Ayoub, Miss. Banoura"	female	13
"Dick, Mrs. Albert Adrian (Vera Gillespie)"	female	17
"Long, Mr. Milton Clyde"	male	29
"Johnston, Mr. Andrew G"	male	85
"Ali, Mr. William"	male	25
"Harmer, Mr. Abraham (David Lishin)"	male	25
"Sjoblom, Miss. Anna Sofia"	female	18
"Rice, Master. George Hugh"	male	8
"Dean, Master. Bertram Vere"	male	1
"Guggenheim, Mr. Benjamin"	male	46
"Keane, Mr. Andrew ""Andy"""	male	85
"Gaskell, Mr. Alfred"	male	16
"Sage, Miss. Stella Anna"	female	15
"Hoyt, Mr. William Fisher"	male	15
"Dantcheff, Mr. Ristiu"	male	25
"Otter, Mr. Richard"	male	39
"Leader, Dr. Alice (Farnham)"	female	49
"Osman, Mrs. Mara"	female	31
"Ibrahim Shawah, Mr. Yousseff"	male	30
"Van Impe, Mrs. Jean Baptiste (Rosalie Paula Govaert)"	female	30
"Ponesell, Mr. Martin"	male	34
"Collyer, Mrs. Harvey (Charlotte Annie Tate)"	female	31
"Carter, Master. William Thornton II"	male	11
"Thomas, Master. Assad Alexander"	male	0.42
"Hedman, Mr. Oskar Arvid"	male	27
"Johansson, Mr. Karl Johan"	male	31
"Andrews, Mr. Thomas Jr"	male	39
"Pettersson, Miss. Ellen Natalia"	female	18
"Meyer, Mr. August"	male	39
"Chambers, Mrs. Norman Campbell (Bertha Griggs)"	female	33
"Alexander, Mr. William"	male	26
"Lester, Mr. James"	male	39
"Slemen, Mr. Richard James"	male	35
"Andersson, Miss. Ebba Iris Alfrida"	female	6
"Tomlin, Mr. Ernest Portage"	male	30.5
"Fry, Mr. Richard"	male	15
"Heininen, Miss. Wendla Maria"	female	23
"Mallet, Mr. Albert"	male	31
"Holm, Mr. John Fredrik Alexander"	male	43
"Skoog, Master. Karl Thorsten"	male	10
"Hays, Mrs. Charles Melville (Clara Jennings Gregg)"	female	52
"Lulic, Mr. Nikola"	male	27
"Reuchlin, Jonkheer. John George"	male	38
"Moor, Mrs. (Beila)"	female	27
"Panula, Master. Urho Abraham"	male	2
"Flynn, Mr. John"	male	15
"Lam, Mr. Len"	male	15
"Mallet, Master. Andre"	male	1
"McCormack, Mr. Thomas Joseph"	male	15
"Stone, Mrs. George Nelson (Martha Evelyn)"	female	62
"Yasbeck, Mrs. Antoni (Selini Alexander)"	female	15
"Richards, Master. George Sibley"	male	0.83
"Saad, Mr. Amin"	male	15
"Augustsson, Mr. Albert"	male	23
"Allum, Mr. Owen George"	male	18
"Compton, Miss. Sara Rebecca"	female	39
"Pasic, Mr. Jakob"	male	21
"Sirota, Mr. Maurice"	male	15
"Chip, Mr. Chang"	male	32
"Marechal, Mr. Pierre"	male	15
"Alhomaki, Mr. Ilmari Rudolf"	male	20
"Mudd, Mr. Thomas Charles"	male	16
"Serepeca, Miss. Augusta"	female	30
"Lemberopolous, Mr. Peter L"	male	34.5
"Culumovic, Mr. Jeso"	male	17
"Abbing, Mr. Anthony"	male	42
"Sage, Mr. Douglas Bullen"	male	15
"Markoff, Mr. Marin"	male	35
"Harper, Rev. John"	male	28
"Goldenberg, Mrs. Samuel L (Edwiga Grabowska)"	female	15
"Andersson, Master. Sigvard Harald Elias"	male	4
"Svensson, Mr. Johan"	male	74
"Boulos, Miss. Nourelain"	female	9
"Lines, Miss. Mary Conover"	female	16
"Carter, Mrs. Ernest Courtenay (Lilian Hughes)"	female	44
"Aks, Mrs. Sam (Leah Rosen)"	female	18
"Wick, Mrs. George Dennick (Mary Hitchcock)"	female	45
"Daly, Mr. Peter Denis "	male	51
"Baclini, Mrs. Solomon (Latifa Qurban)"	female	24
"Razi, Mr. Raihed"	male	15
"Hansen, Mr. Claus Peter"	male	41
"Giles, Mr. Frederick Edward"	male	21
"Swift, Mrs. Frederick Joel (Margaret Welles Barron)"	female	48
"Sage, Miss. Dorothy Edith ""Dolly"""	female	15
"Gill, Mr. John William"	male	24
"Bystrom, Mrs. (Karolina)"	female	42
"Duran y More, Miss. Asuncion"	female	27
"Roebling, Mr. Washington Augustus II"	male	31
"van Melkebeke, Mr. Philemon"	male	15
"Johnson, Master. Harold Theodor"	male	4
"Balkic, Mr. Cerin"	male	26
"Beckwith, Mrs. Richard Leonard (Sallie Monypeny)"	female	47
"Carlsson, Mr. Frans Olof"	male	33
"Vander Cruyssen, Mr. Victor"	male	47
"Abelson, Mrs. Samuel (Hannah Wizosky)"	female	28
"Najib, Miss. Adele Kiamie ""Jane"""	female	15
"Gustafsson, Mr. Alfred Ossian"	male	20
"Petroff, Mr. Nedelio"	male	19
"Laleff, Mr. Kristo"	male	15
"Potter, Mrs. Thomas Jr (Lily Alexenia Wilson)"	female	56
"Shelley, Mrs. William (Imanita Parrish Hall)"	female	25
"Markun, Mr. Johann"	male	33
"Dahlberg, Miss. Gerda Ulrika"	female	22
"Banfield, Mr. Frederick James"	male	28
"Sutehall, Mr. Henry Jr"	male	25
"Rice, Mrs. William (Margaret Norton)"	female	39
"Montvila, Rev. Juozas"	male	27
"Graham, Miss. Margaret Edith"	female	19
"Johnston, Miss. Catherine Helen ""Carrie"""	female	15
"Behr, Mr. Karl Howell"	male	26
"Dooley, Mr. Patrick"	male	32
